81 12 14 21 16 3 6 14 1 5 6 15 20 3 11 5 15 25 17 8 9
83 16 23 5 11 14 20 1 12 16 7 8 13 10 22 11 24 20 4 2 4
76 5 19 18 5 6 17 4 19 19 17 6 7 12 16 2 4 11 4 18 10
71 19 14 5 18 16 22 17 3 3 18 22 19 18 12 14 1 8 15 15 12
53 18 6 17 10 23 25 9 12 6 5 18 5 9 15 7 3 8 15 11 18
5 17 1 9 4 9 23 11 25 11 4 20 16 21 13 13 7 12 12 22 10
80 21 14 17 11 21 21 14 5 7 20 7 16 2 21 17 13 2 18 15 19
57 8 23 15 4 2 14 1 9 15 23 8 8 4 1 19 11 3 14 18 11
66 15 19 7 15 21 14 23 25 22 7 24 5 7 8 21 21 17 18 17 8
47 6 21 23 18 21 22 9 18 13 21 2 10 5 24 4 8 11 7 17 24
96 11 21 8 2 22 21 2 10 10 12 23 15 6 2 12 3 21 5 24 7
99 19 5 17 1 8 12 23 23 4 22 18 10 2 12 8 8 5 17 14 4
36 11 11 8 10 10 18 10 15 10 5 7 15 5 10 24 15 18 19 2 5
40 6 25 22 12 14 18 19 4 23 13 2 10 23 12 18 19 9 2 20 11
32 16 15 8 10 5 10 23 3 10 10 25 9 25 2 10 22 11 8 25 2
78 22 19 11 14 17 23 24 6 8 14 11 14 16 1 15 7 13 5 15 1
68 2 17 9 17 22 17 15 1 11 16 17 8 5 18 4 16 3 25 20 16
73 19 8 6 23 25 19 5 4 21 15 2 21 12 20 5 23 24 1 8 4
66 25 18 10 9 8 6 17 9 12 18 9 7 1 25 14 8 2 22 7 17
93 12 25 13 6 22 22 20 15 9 21 1 11 22 22 12 11 5 22 9 3
16 5 7 21 12 4 6 17 23 18 22 5 16 8 22 24 7 18 18 6 14
31 23 20 11 25 21 6 16 22 9 8 5 18 15 3 20 21 9 21 23 21
80 17 8 17 16 10 25 9 6 5 22 18 23 12 5 14 23 18 20 2 23
83 13 13 14 1 16 8 10 12 7 25 15 4 19 22 24 8 2 17 20 16
7 20 10 14 16 1 21 6 8 2 21 18 14 19 3 18 2 22 10 20 15
