65 24 10 19 22 5 20 8 19 15 17 21 24 25 20 11 4 22 2 22 13
33 4 13 8 17 11 24 6 18 17 20 18 1 16 14 21 9 18 7 24 19
56 1 6 15 18 15 8 2 6 20 13 5 4 4 21 6 23 2 6 3 10
30 12 14 8 1 9 20 24 8 13 13 20 14 24 16 12 24 21 2 7 11
94 19 14 12 10 12 11 1 19 20 1 14 1 15 19 17 17 4 5 2 7
89 13 17 13 20 14 13 24 14 14 5 17 21 4 15 2 21 2 20 5 21
43 6 9 3 10 4 18 17 24 24 8 4 16 6 25 10 15 14 23 13 12
77 2 3 12 3 11 15 7 3 22 20 1 6 24 6 19 3 8 24 19 13
61 20 15 14 6 5 2 22 25 25 15 6 10 21 15 13 16 9 4 12 13
98 1 13 18 21 10 14 2 22 2 1 18 2 2 21 13 24 22 19 8 20
7 15 10 11 17 5 3 21 18 5 24 6 13 8 6 18 17 18 20 25 15
68 2 10 5 23 2 3 14 15 17 20 17 22 21 11 18 1 13 4 6 14
41 20 11 17 6 18 1 5 25 4 11 18 19 2 12 15 23 22 16 3 2
49 12 17 16 7 5 4 23 22 23 5 3 22 9 4 18 6 17 13 2 8
17 13 16 21 18 10 9 19 25 7 25 20 19 23 21 19 13 12 21 9 1
52 24 14 6 17 23 16 16 1 9 7 21 20 9 5 18 19 14 7 3 9
2 12 10 1 23 24 20 3 6 22 5 13 25 10 7 23 24 1 18 21 22
65 13 15 19 18 16 4 17 14 24 18 19 17 11 12 18 7 2 19 13 22
30 13 11 17 20 5 14 19 15 5 18 5 19 5 16 10 10 15 16 1 25
7 20 13 4 18 1 5 2 23 18 13 6 12 3 14 20 17 5 2 10 18
65 11 14 10 16 23 20 14 19 6 1 24 5 7 21 1 22 10 21 12 13
55 22 23 22 19 22 1 24 10 11 14 13 16 10 3 12 20 16 7 4 5
13 23 21 12 12 13 8 12 16 16 6 20 8 3 3 6 20 13 10 12 21
90 6 13 8 10 15 2 9 23 3 14 9 15 12 6 6 15 20 13 7 1
74 16 21 16 20 6 5 4 9 18 15 18 7 25 12 7 15 12 22 8 8
